"filename", "language", "Markdown", "C++", "Log", "comment", "blank", "total"
"/home/lucas/repos/Pathfinding-Visualization/README.md", "Markdown", 11, 0, 0, 0, 6, 17
"/home/lucas/repos/Pathfinding-Visualization/Testing/Temporary/LastTest.log", "Log", 0, 0, 3, 0, 1, 4
"/home/lucas/repos/Pathfinding-Visualization/src/DEFINITIONS.h", "C++", 0, 19, 0, 3, 10, 32
"/home/lucas/repos/Pathfinding-Visualization/src/Game.cpp", "C++", 0, 33, 0, 3, 13, 49
"/home/lucas/repos/Pathfinding-Visualization/src/Game.h", "C++", 0, 23, 0, 3, 11, 37
"/home/lucas/repos/Pathfinding-Visualization/src/Grid.h", "C++", 0, 39, 0, 3, 12, 54
"/home/lucas/repos/Pathfinding-Visualization/src/GridMap.cpp", "C++", 0, 111, 0, 10, 33, 154
"/home/lucas/repos/Pathfinding-Visualization/src/GridMap.h", "C++", 0, 28, 0, 3, 9, 40
"/home/lucas/repos/Pathfinding-Visualization/src/Surface.cpp", "C++", 0, 203, 0, 10, 55, 268
"/home/lucas/repos/Pathfinding-Visualization/src/Surface.h", "C++", 0, 43, 0, 3, 24, 70
"/home/lucas/repos/Pathfinding-Visualization/src/engine/AssetManager.cpp", "C++", 0, 32, 0, 3, 10, 45
"/home/lucas/repos/Pathfinding-Visualization/src/engine/AssetManager.h", "C++", 0, 23, 0, 3, 14, 40
"/home/lucas/repos/Pathfinding-Visualization/src/engine/InputManager.cpp", "C++", 0, 20, 0, 3, 7, 30
"/home/lucas/repos/Pathfinding-Visualization/src/engine/InputManager.h", "C++", 0, 14, 0, 3, 9, 26
"/home/lucas/repos/Pathfinding-Visualization/src/engine/README.md", "Markdown", 1, 0, 0, 0, 0, 1
"/home/lucas/repos/Pathfinding-Visualization/src/engine/State.h", "C++", 0, 19, 0, 3, 10, 32
"/home/lucas/repos/Pathfinding-Visualization/src/engine/StateMachine.cpp", "C++", 0, 36, 0, 3, 10, 49
"/home/lucas/repos/Pathfinding-Visualization/src/engine/StateMachine.h", "C++", 0, 24, 0, 3, 13, 40
"/home/lucas/repos/Pathfinding-Visualization/src/main.cpp", "C++", 0, 13, 0, 0, 4, 17
"/home/lucas/repos/Pathfinding-Visualization/src/pathfinding/BFSFinding.cpp", "C++", 0, 69, 0, 6, 16, 91
"/home/lucas/repos/Pathfinding-Visualization/src/pathfinding/BFSFinding.h", "C++", 0, 23, 0, 3, 6, 32
"/home/lucas/repos/Pathfinding-Visualization/src/pathfinding/Pathfinding.cpp", "C++", 0, 11, 0, 5, 6, 22
"/home/lucas/repos/Pathfinding-Visualization/src/pathfinding/Pathfinding.h", "C++", 0, 21, 0, 3, 12, 36
"/home/lucas/repos/Pathfinding-Visualization/src/states/GameState.cpp", "C++", 0, 40, 0, 3, 14, 57
"/home/lucas/repos/Pathfinding-Visualization/src/states/GameState.h", "C++", 0, 20, 0, 3, 11, 34
"/home/lucas/repos/Pathfinding-Visualization/src/states/MainState.cpp", "C++", 0, 79, 0, 6, 20, 105
"/home/lucas/repos/Pathfinding-Visualization/src/states/MainState.h", "C++", 0, 21, 0, 3, 11, 35
"/home/lucas/repos/Pathfinding-Visualization/src/states/SplashState.cpp", "C++", 0, 52, 0, 4, 13, 69
"/home/lucas/repos/Pathfinding-Visualization/src/states/SplashState.h", "C++", 0, 20, 0, 3, 11, 34
"Total", "-", 12, 1036, 3, 98, 371, 1520