"filename", "language", "C++", "Log", "Markdown", "comment", "blank", "total"
"/home/lucas/repos/Pathfinding-Visualization/README.md", "Markdown", 0, 0, 11, 0, 6, 17
"/home/lucas/repos/Pathfinding-Visualization/Testing/Temporary/LastTest.log", "Log", 0, 3, 0, 0, 1, 4
"/home/lucas/repos/Pathfinding-Visualization/src/DEFINITIONS.h", "C++", 19, 0, 0, 3, 10, 32
"/home/lucas/repos/Pathfinding-Visualization/src/Game.cpp", "C++", 32, 0, 0, 3, 13, 48
"/home/lucas/repos/Pathfinding-Visualization/src/Game.h", "C++", 23, 0, 0, 3, 11, 37
"/home/lucas/repos/Pathfinding-Visualization/src/Grid.h", "C++", 39, 0, 0, 3, 12, 54
"/home/lucas/repos/Pathfinding-Visualization/src/GridMap.cpp", "C++", 107, 0, 0, 10, 33, 150
"/home/lucas/repos/Pathfinding-Visualization/src/GridMap.h", "C++", 28, 0, 0, 3, 10, 41
"/home/lucas/repos/Pathfinding-Visualization/src/Surface.cpp", "C++", 199, 0, 0, 10, 52, 261
"/home/lucas/repos/Pathfinding-Visualization/src/Surface.h", "C++", 43, 0, 0, 3, 24, 70
"/home/lucas/repos/Pathfinding-Visualization/src/engine/AssetManager.cpp", "C++", 32, 0, 0, 3, 10, 45
"/home/lucas/repos/Pathfinding-Visualization/src/engine/AssetManager.h", "C++", 23, 0, 0, 3, 14, 40
"/home/lucas/repos/Pathfinding-Visualization/src/engine/InputManager.cpp", "C++", 20, 0, 0, 3, 7, 30
"/home/lucas/repos/Pathfinding-Visualization/src/engine/InputManager.h", "C++", 14, 0, 0, 3, 9, 26
"/home/lucas/repos/Pathfinding-Visualization/src/engine/README.md", "Markdown", 0, 0, 1, 0, 0, 1
"/home/lucas/repos/Pathfinding-Visualization/src/engine/State.h", "C++", 19, 0, 0, 3, 10, 32
"/home/lucas/repos/Pathfinding-Visualization/src/engine/StateMachine.cpp", "C++", 36, 0, 0, 3, 10, 49
"/home/lucas/repos/Pathfinding-Visualization/src/engine/StateMachine.h", "C++", 24, 0, 0, 3, 13, 40
"/home/lucas/repos/Pathfinding-Visualization/src/main.cpp", "C++", 13, 0, 0, 0, 4, 17
"/home/lucas/repos/Pathfinding-Visualization/src/pathfinding/BFSFinding.cpp", "C++", 56, 0, 0, 6, 16, 78
"/home/lucas/repos/Pathfinding-Visualization/src/pathfinding/BFSFinding.h", "C++", 26, 0, 0, 16, 6, 48
"/home/lucas/repos/Pathfinding-Visualization/src/pathfinding/DijkstraFinding.cpp", "C++", 13, 0, 0, 3, 9, 25
"/home/lucas/repos/Pathfinding-Visualization/src/pathfinding/DijkstraFinding.h", "C++", 17, 0, 0, 3, 11, 31
"/home/lucas/repos/Pathfinding-Visualization/src/pathfinding/Pathfinding.cpp", "C++", 11, 0, 0, 5, 6, 22
"/home/lucas/repos/Pathfinding-Visualization/src/pathfinding/Pathfinding.h", "C++", 21, 0, 0, 3, 12, 36
"/home/lucas/repos/Pathfinding-Visualization/src/states/GameState.cpp", "C++", 40, 0, 0, 3, 14, 57
"/home/lucas/repos/Pathfinding-Visualization/src/states/GameState.h", "C++", 20, 0, 0, 3, 11, 34
"/home/lucas/repos/Pathfinding-Visualization/src/states/MainState.cpp", "C++", 79, 0, 0, 6, 20, 105
"/home/lucas/repos/Pathfinding-Visualization/src/states/MainState.h", "C++", 21, 0, 0, 3, 11, 35
"/home/lucas/repos/Pathfinding-Visualization/src/states/SplashState.cpp", "C++", 52, 0, 0, 4, 13, 69
"/home/lucas/repos/Pathfinding-Visualization/src/states/SplashState.h", "C++", 20, 0, 0, 3, 11, 34
"Total", "-", 1047, 3, 12, 117, 389, 1568